#################################################################################
#   #   #     #   #   #   # #     #   # #         # #   #   #       #           #
# # # ### # ##### ###               ### ##### # ### # # # ### # # ### ### # # ###
# # # #   # #       # # # #   # # # # #   #   # #     #   # # # #     #   # # # #
### # # ### #       # # ####### # # # ### # ######### ### # # ####### ### ##### #
#   #     #   # # #       #     #     #       #   #   # # #   # #     #   #   # #
# ##### ############# # ### ### # ##### ##### # # ### # ### ### # # ##### # ### #
# #   #     #   #     # #   #   #     #   #     #       # # #     #     #       #
# # # ######### ##### ### ### ### ### # ### ### ### ##### ##### # ####### ##### #
#   #           #       #   # # #   # #                       # # #       # #   #
# # ####### ##### # ### #       ### #####                     ##### ####### # ###
# # #       #     # #     #     #           # # # #     #     #       #   #     #
##### # ### # ##### # ####### # # ##### # ### # ####### ##### # ### ##### # ### #
#     # #   # #     #   #   # # # # # # #   # #     # #   #   # #   # #   # #   #
# ### ##### # # # ##### # # ### # # # # ### #             # ### ##### # ##### # #
# # #     #   # # #       # # #       # # #   #   # #   # #   #       #       # #
# # ######### ###           # # ######### ######### ### # # # # # # ##### ### ###
#   #         #   #     # # #     # #     #     #   #   #   # # # #   #     #   #
# ### # ### # # # ####### # # ##### # ####### ##### ### # ### ### ### # # #######
#   # # #   # # #   #       #   #                     #   #         # # #       #
#################################################################################